32
37
1111111111111111111111111111111111110
1111111111111111111111111111111111110
1111111111111111111111111111111111110
0111111111111111111111111111111111110
0111111111111111111111111100000000110
0111111111111111111111111101111110110
0100000000000000000000000000000110110
0111114111111111111111111111010110110
0000000100010100010000010101010110110
0111110101110111111111010101110100110
0100000101000100000001010101010110110
0111110111011101111111111101010110110
0000010100010101010001000001010000110
0111110101110101011101011101110111110
0111110101000101000101010101000111110
0110000111011101110101110111110110000
0110110100010000010100000000010111110
0110110101111111010111111111110111110
0110110101000001010000000100010000110
0111110101111111011111110111010110110
0111110100000001000000010001010110110
0100000101111111011111111101010110110
0111110101010001010000010101010110110
0111000111011101011101110101010000110
0111110101000101000101000101010110110
0111110101011101111101111101110110110
0110000101010101000000000100010110110
0111110101010101111111110111110110000
1111110101010101000000010100010111111
1111110111011111111111110111110111111
1111110000000000000000000000000111111
1111111111111111111111111111111111111