25
25
0000000000000000000000000
4111111111111111111111010
0100010100010000010101010
0101110111111111010101110
0101000100000001010101010
0111011101111111111101010
0100010101010001000001010
0101110101011101011101110
0101000101000101010101000
0111011101110101110111110
0100010000010100000000010
0101111111010111111111110
0101000001010000000100010
0101111111011111110111010
0100000001000000010001010
0101111111011111111101010
0101010001010000010101010
0111011101011101110101010
0101000101000101000101010
0101011101111101111101110
0101010101000000000100010
0101010101111111110111110
0101010101000000010100010
0111011111111111110111110
0000000000000000000000000
